0 1 2 3 0 1 2 3 0 1 2 3 0 1 2 3 0 1 2 3 0 1 2 4 5 6 7 8 0 1 2 3 0 1 2 3 0 1 2 3 0 1 2 3 0 
9 10 11 12 13 14 11 12 13 14 11 12 13 14 11 12 13 14 11 12 13 14 11 15 6 5 16 12 13 14 11 12 13 14 11 12 13 14 11 12 13 14 11 12 9 
17 18 19 20 21 22 23 24 21 22 23 24 21 22 23 24 21 22 23 24 21 22 23 25 5 6 7 24 21 22 23 24 21 22 23 24 21 22 23 24 21 22 23 26 17 
27 28 29 30 31 32 33 32 33 32 33 32 33 32 33 32 33 32 33 32 33 32 33 34 5 5 35 32 33 32 33 32 33 32 33 32 33 32 33 32 33 36 37 38 27 
0 1 2 4 5 5 6 5 6 5 6 5 6 5 6 5 6 5 6 5 6 5 6 5 6 6 5 5 6 5 6 5 6 5 6 5 6 5 6 5 6 7 39 8 0 
9 10 11 15 6 6 5 6 5 6 5 6 5 6 5 6 5 6 5 6 5 6 5 6 5 6 5 6 5 6 5 6 5 6 5 40 41 40 41 40 41 42 43 44 9 
17 18 19 45 5 5 6 5 6 46 47 48 48 48 48 48 48 49 50 51 6 5 6 5 6 5 6 46 47 48 48 48 48 48 48 52 53 54 55 56 55 57 39 26 17 
27 28 29 58 6 59 60 60 61 62 63 64 64 64 64 64 64 65 66 67 68 6 5 59 60 60 61 62 63 64 64 64 64 64 64 69 70 71 72 55 56 73 43 38 27 
0 1 2 4 5 7 39 37 74 75 63 64 64 64 64 64 64 65 66 76 25 5 6 7 39 37 74 75 63 64 64 64 64 64 64 69 70 77 78 56 55 57 39 8 0 
9 10 11 15 6 16 37 79 80 75 63 64 64 64 64 64 64 65 66 76 15 6 5 16 37 79 80 75 63 64 64 64 64 64 64 69 70 77 81 55 56 73 43 44 9 
17 18 19 45 5 7 39 39 82 83 84 85 85 85 85 85 85 86 87 88 89 5 6 7 39 39 82 83 84 85 85 85 85 85 85 90 91 92 93 56 55 57 39 26 17 
27 28 29 58 6 16 37 79 80 94 95 96 97 98 96 97 98 99 100 101 15 6 5 16 37 79 80 94 95 96 97 98 96 97 98 99 102 103 81 55 56 73 43 38 27 
0 1 2 4 5 7 39 104 105 94 106 107 108 109 110 111 112 113 114 115 89 5 6 7 39 104 105 94 106 107 108 109 110 111 112 113 116 117 93 56 55 57 39 8 0 
9 10 11 15 6 16 37 118 119 94 95 120 121 122 96 97 98 99 100 101 15 6 5 16 37 118 119 94 95 120 121 122 96 97 98 99 102 103 81 55 56 73 43 44 9 
17 18 19 45 5 7 39 123 124 125 126 127 128 129 130 131 132 133 134 115 89 5 6 7 39 123 124 125 126 127 128 129 130 131 132 133 135 117 93 56 55 57 39 26 17 
27 28 29 58 6 35 33 32 33 32 33 136 5 137 33 32 33 32 33 33 34 6 5 35 33 32 33 32 33 136 5 137 33 32 33 138 139 139 140 55 56 73 43 38 27 
0 1 2 4 5 5 6 5 6 5 6 5 6 5 6 5 6 5 6 5 6 5 6 5 6 5 6 5 6 5 6 5 6 5 6 5 6 5 6 5 6 141 39 8 0 
9 10 11 15 6 6 5 6 5 6 5 6 5 6 5 6 5 6 5 6 5 6 5 6 5 6 5 6 5 6 5 6 5 6 5 6 5 6 5 6 5 16 37 44 9 
17 18 19 45 5 5 6 5 6 5 6 5 6 5 6 5 6 5 6 5 6 5 6 5 6 142 143 143 143 143 143 143 143 143 143 144 145 146 147 148 6 7 39 26 17 
27 28 29 58 6 59 60 60 61 60 61 60 61 60 61 60 61 60 61 60 68 6 5 59 60 149 150 150 150 150 150 150 150 150 150 151 152 153 154 155 6 16 37 38 27 
0 1 2 4 5 7 39 37 74 37 74 37 74 37 74 37 74 37 74 39 25 5 6 7 39 156 157 157 157 157 157 157 157 157 157 158 159 160 161 162 5 7 39 8 0 
9 10 11 15 6 16 37 79 80 163 164 165 164 165 164 165 164 166 167 168 15 6 5 16 37 169 157 157 157 157 157 157 157 157 157 170 171 172 173 174 6 16 37 44 9 
17 18 19 45 5 7 39 39 82 175 176 176 176 176 176 176 176 177 178 179 89 5 6 7 39 180 181 181 181 181 181 181 181 181 181 181 181 181 182 183 5 7 39 26 17 
184 185 186 187 188 189 190 191 192 193 194 193 194 193 195 196 197 198 80 39 15 6 5 16 37 199 200 201 200 201 202 203 203 203 200 201 200 201 204 205 6 16 37 38 27 
206 207 208 209 210 211 39 39 212 213 214 213 214 213 215 216 217 218 82 37 89 5 6 7 39 219 220 221 222 223 224 225 226 227 228 229 230 231 232 233 5 7 39 8 0 
234 235 236 237 188 238 190 191 239 193 194 193 194 193 195 240 197 198 80 39 15 6 5 16 37 241 242 243 244 245 246 247 248 249 243 244 245 250 232 205 6 16 37 44 9 
251 252 253 209 210 211 39 39 212 213 214 213 214 213 215 216 217 218 82 37 89 5 6 7 39 254 255 256 257 258 259 260 261 262 256 257 258 255 263 233 5 7 39 26 17 
264 265 266 237 188 267 268 269 268 269 268 269 268 269 33 270 271 272 271 271 273 6 5 35 33 32 33 32 33 32 33 136 5 137 33 32 33 32 33 34 5 16 37 38 27 
206 207 208 209 210 210 188 210 188 210 188 210 188 274 6 275 276 277 278 279 278 5 6 5 6 5 6 5 6 56 55 5 6 5 6 5 6 5 6 5 6 7 39 8 0 
234 235 236 237 188 188 210 188 210 188 210 188 210 280 5 210 281 282 279 283 279 6 5 6 5 6 5 6 5 55 56 6 5 6 5 6 5 6 5 6 5 16 37 44 9 
251 252 253 209 210 210 188 210 188 210 188 210 188 274 6 284 285 286 283 279 283 5 6 5 6 5 6 5 6 56 55 5 6 5 6 5 6 5 6 5 6 7 39 26 17 
264 265 266 287 288 288 289 288 289 288 289 288 289 288 68 290 291 292 279 283 279 6 5 6 5 293 294 295 294 295 294 296 297 298 294 295 294 299 5 6 5 16 37 38 27 
206 207 208 39 39 190 39 190 39 190 39 190 39 39 25 5 300 5 300 5 300 5 6 5 6 301 302 303 302 303 302 304 305 306 302 303 302 307 6 5 6 7 39 8 0 
234 308 309 191 310 311 239 191 310 311 239 191 239 312 313 314 315 314 315 314 316 317 61 60 61 60 61 60 61 60 61 60 61 60 61 60 61 60 61 60 61 318 319 12 9 
251 320 321 322 323 324 325 322 323 324 325 39 212 326 327 328 329 328 329 328 330 331 74 37 74 37 74 37 74 37 74 332 333 74 334 37 74 37 74 37 74 39 37 335 17 
264 265 266 336 337 338 339 336 337 338 339 191 239 340 341 342 343 342 343 342 344 345 80 346 347 348 347 348 347 348 347 349 350 347 351 348 347 348 352 353 80 198 80 354 27 
206 207 208 355 356 357 358 355 356 357 358 39 212 326 327 328 329 328 329 328 330 359 82 360 361 362 361 362 361 362 363 364 362 363 364 362 361 362 365 366 82 39 82 8 0 
234 235 236 367 234 235 236 367 234 235 236 191 239 340 341 342 343 342 343 342 344 345 80 198 80 198 80 198 80 198 368 369 198 368 369 198 370 371 80 198 370 371 80 12 9 
251 252 253 372 251 252 373 372 251 252 373 39 212 326 327 328 329 328 329 328 330 359 82 39 82 39 82 39 82 39 82 39 82 39 82 374 375 376 377 374 375 376 377 26 17 
264 265 266 378 264 265 266 378 264 265 266 379 379 340 341 342 343 342 343 342 344 380 164 165 164 165 164 165 164 165 164 165 164 381 382 383 27 28 29 384 27 28 29 384 27 