385 385 385 385 385 385 385 385 385 385 385 385 385 385 385 385 385 385 385 385 385 385 385 388 388 388 388 385 385 385 385 385 385 385 385 385 385 385 385 385 385 385 385 385 385 385 
385 385 385 385 385 385 385 385 385 385 385 385 385 385 385 385 385 385 385 385 385 385 385 15 6 5 16 385 385 385 385 385 385 385 385 385 385 385 385 385 385 385 385 385 385 385 
385 385 392 20 21 22 23 24 21 22 23 24 21 22 23 24 21 22 23 24 21 22 23 25 5 6 7 24 21 22 23 24 21 22 23 24 21 22 23 24 21 22 23 392 385 385 
385 385 392 30 31 32 33 32 33 32 33 32 33 32 33 32 33 32 33 32 33 32 33 34 5 5 35 32 33 32 33 32 33 32 33 32 33 32 33 32 33 36 37 392 385 385 
385 385 392 4 5 5 6 5 6 5 6 5 6 5 6 5 6 5 6 5 6 5 6 5 6 6 5 5 6 5 6 5 6 5 6 5 6 5 6 5 6 7 39 392 385 385 
385 385 392 15 6 6 5 6 5 6 5 6 5 6 5 6 5 6 5 5 5 6 5 6 5 6 5 6 5 6 5 6 5 6 5 40 41 40 41 40 41 42 43 392 385 385 
385 385 392 45 5 5 6 5 6 392 392 392 392 392 392 392 392 392 392 51 6 5 6 5 6 5 6 392 392 392 392 392 392 392 392 392 392 54 55 56 55 57 39 392 385 385 
385 385 392 58 6 35 33 33 32 385 385 385 385 385 385 385 385 385 385 67 34 6 5 35 33 33 32 385 385 385 385 385 385 385 385 385 385 71 72 55 56 73 43 392 385 385 
385 385 392 4 5 7 39 37 74 385 385 385 385 385 385 385 385 385 385 76 25 5 6 7 39 37 74 385 385 385 385 385 385 385 385 385 385 77 78 56 55 57 39 392 385 385 
385 385 392 15 6 16 37 79 80 385 385 385 385 385 385 385 385 385 385 76 15 6 5 16 37 79 80 385 385 385 385 385 385 385 385 385 385 77 81 55 56 73 43 392 385 385 
385 385 392 45 5 7 39 39 82 385 385 385 385 385 385 385 385 385 385 88 89 5 6 7 39 39 82 385 385 385 385 385 385 385 385 385 385 92 93 56 55 57 39 392 385 385 
385 385 392 58 6 16 37 79 80 385 385 385 385 385 385 385 385 385 385 101 15 6 5 16 37 79 80 385 385 385 385 385 385 385 385 385 385 103 81 55 56 73 43 392 385 385 
385 385 392 4 5 7 39 392 392 385 385 385 385 385 385 385 385 385 385 115 89 5 6 7 39 392 392 385 385 385 385 385 385 385 385 385 385 117 93 56 55 57 39 392 385 385 
385 385 392 15 6 16 37 385 385 385 385 391 391 385 385 385 385 385 385 101 15 6 5 16 37 385 385 385 385 390 390 385 385 385 385 385 385 103 81 55 56 73 43 392 385 385 
385 385 392 45 5 7 39 385 385 385 385 127 128 385 385 385 385 385 385 115 89 5 6 7 39 385 385 385 385 127 128 385 385 385 385 385 385 117 93 56 55 57 39 392 385 385 
385 385 392 58 6 35 33 32 33 32 33 136 5 137 33 32 33 32 33 33 34 6 5 35 33 32 33 32 33 136 5 137 33 32 33 138 139 139 72 55 56 73 43 392 385 385 
385 385 392 4 5 5 6 5 6 5 6 5 6 5 6 5 6 5 6 5 6 5 6 5 6 5 6 5 6 5 6 5 6 5 6 5 6 5 6 5 6 141 39 392 385 385 
385 385 392 15 6 6 5 6 5 6 5 6 5 6 5 6 5 6 5 6 5 6 5 6 5 6 5 6 5 6 5 6 5 6 5 6 5 6 5 6 5 16 37 392 385 385 
385 385 392 45 5 5 6 5 6 5 6 5 6 5 6 5 6 5 6 5 6 5 6 5 6 392 392 392 392 392 392 392 392 392 392 392 392 392 392 148 6 7 39 392 385 385 
385 385 392 58 6 35 33 33 32 33 32 33 32 33 32 33 32 33 32 33 34 6 5 35 33 385 385 385 385 385 385 385 385 385 385 385 385 385 385 155 6 16 37 392 385 385 
385 385 392 4 5 7 39 37 74 37 74 37 74 37 74 37 74 37 74 39 25 5 6 7 39 385 385 385 385 385 385 385 385 385 385 385 385 385 385 162 5 7 39 392 385 385 
385 385 392 15 6 16 37 79 80 163 164 165 164 165 164 165 164 392 392 168 15 6 5 16 37 385 385 385 385 385 385 385 385 385 385 385 385 385 385 174 6 16 37 392 385 385 
385 385 392 45 5 7 39 39 82 385 385 385 385 385 385 385 385 385 385 179 89 5 6 7 39 385 385 385 385 385 385 385 385 385 385 385 385 385 385 183 5 7 39 392 385 385 
385 385 392 187 188 189 190 191 192 193 194 193 194 193 195 196 197 198 80 39 15 6 5 16 37 385 385 385 385 385 385 385 385 385 385 385 385 385 385 205 6 16 37 392 385 385 
385 385 392 209 210 209 39 39 212 213 214 213 214 213 215 216 217 218 82 37 89 5 6 7 39 385 385 385 385 385 385 385 385 385 385 385 385 385 385 233 5 7 39 392 385 385 
385 385 392 237 188 237 190 191 239 193 194 193 194 193 195 240 197 198 80 39 15 6 5 16 37 385 385 385 385 385 385 387 387 385 385 385 385 385 385 205 6 16 37 392 385 385 
385 385 392 209 210 209 39 39 212 213 214 213 214 213 215 216 217 218 82 37 89 5 6 7 39 385 385 385 385 385 385 260 261 385 385 385 385 385 385 233 5 7 39 392 385 385 
385 385 392 237 188 267 209 269 209 269 209 269 209 269 33 270 271 272 271 271 273 6 5 35 33 32 33 32 33 32 33 136 5 137 33 32 33 32 33 34 5 16 37 392 385 385 
385 385 392 209 210 210 188 210 188 210 188 210 188 274 6 282 282 277 278 277 278 5 6 5 6 5 6 5 6 56 55 5 6 5 6 5 6 5 6 5 6 7 39 392 385 385 
385 385 392 237 188 188 210 188 210 188 210 188 210 279 5 282 282 282 277 282 277 6 5 6 5 6 5 6 5 55 56 6 5 6 5 6 5 6 5 6 5 16 37 392 385 385 
385 385 392 209 210 210 188 210 188 210 188 210 188 274 6 282 282 277 282 277 282 5 6 5 6 5 6 5 6 56 55 5 6 5 6 5 6 5 6 5 6 7 39 392 385 385 
385 385 392 285 209 209 269 209 269 209 269 209 269 209 34 282 277 282 277 282 277 6 5 6 5 288 289 290 289 290 289 392 392 293 289 290 289 294 5 6 5 16 37 392 385 385 
385 385 392 39 39 190 39 190 39 190 39 190 39 39 25 5 295 5 295 5 295 5 6 5 6 385 385 385 385 385 385 385 385 385 385 385 385 302 6 5 6 7 39 392 385 385 
385 385 392 191 392 392 239 191 392 392 239 191 239 386 386 386 386 386 386 386 386 312 32 33 32 33 32 33 32 33 32 33 32 33 32 33 32 33 32 33 32 36 314 392 385 385 
385 385 392 392 392 392 392 392 392 392 392 39 212 386 386 386 386 386 386 386 386 326 74 37 74 37 74 37 74 37 190 190 190 37 74 37 74 37 74 37 74 39 37 392 385 385 
385 385 392 392 392 392 392 392 392 392 392 191 239 386 386 386 386 386 386 386 386 339 80 340 341 342 341 342 341 342 341 342 342 342 341 342 341 342 346 347 80 198 80 392 385 385 
385 385 385 385 385 385 385 385 385 385 385 39 212 386 386 386 386 386 386 386 386 353 82 354 355 356 355 356 355 356 355 355 355 356 355 356 355 356 360 361 82 39 82 392 385 385 
385 385 385 385 385 385 385 385 385 385 385 191 239 386 386 386 386 386 386 386 386 339 80 198 80 198 80 198 80 198 80 198 80 198 80 198 392 392 80 198 392 392 80 392 385 385 
385 385 385 385 385 385 385 385 385 385 385 39 212 386 386 386 386 386 386 386 386 353 82 39 82 39 82 39 82 39 82 39 82 39 82 392 392 392 392 392 392 392 392 392 385 385 
385 385 385 385 385 385 385 385 385 385 385 385 385 386 386 386 386 386 386 386 386 385 385 385 385 385 385 385 385 385 385 385 385 385 385 392 392 392 392 392 392 392 392 392 385 385 
385 385 385 385 385 385 385 385 385 385 385 385 385 389 389 389 389 389 389 389 389 385 385 385 385 385 385 385 385 385 385 385 385 385 385 385 385 385 385 385 385 385 385 385 385 385 

