tileswide 46
tileshigh 41
tilewidth 16
tileheight 16

layer 0
385,385,385,385,385,385,385,385,385,385,385,385,385,385,385,385,385,385,385,385,385,385,385,388,388,388,388,385,385,385,385,385,385,385,385,385,385,385,385,385,385,385,385,385,385,385,
385,385,385,385,385,385,385,385,385,385,385,385,385,385,385,385,385,385,385,385,385,385,385,15,6,5,16,385,385,385,385,385,385,385,385,385,385,385,385,385,385,385,385,385,385,385,
385,385,19,20,21,22,23,24,21,22,23,24,21,22,23,24,21,22,23,24,21,22,23,25,5,6,7,24,21,22,23,24,21,22,23,24,21,22,23,24,21,22,23,26,385,385,
385,385,29,30,31,32,33,32,33,32,33,32,33,32,33,32,33,32,33,32,33,32,33,34,5,5,35,32,33,32,33,32,33,32,33,32,33,32,33,32,33,36,37,38,385,385,
385,385,2,4,5,5,6,5,6,5,6,5,6,5,6,5,6,5,6,5,6,5,6,5,6,6,5,5,6,5,6,5,6,5,6,5,6,5,6,5,6,7,39,8,385,385,
385,385,11,15,6,6,5,6,5,6,5,6,5,6,5,6,5,6,5,5,5,6,5,6,5,6,5,6,5,6,5,6,5,6,5,40,41,40,41,40,41,42,43,44,385,385,
385,385,19,45,5,5,6,5,6,46,47,48,48,48,48,48,48,49,50,51,6,5,6,5,6,5,6,46,47,48,48,48,48,48,48,52,53,54,55,56,55,57,39,26,385,385,
385,385,29,58,6,59,60,60,61,385,385,385,385,385,385,385,385,385,385,67,68,6,5,59,60,60,61,385,385,385,385,385,385,385,385,385,385,71,72,55,56,73,43,38,385,385,
385,385,2,4,5,7,39,37,74,385,385,385,385,385,385,385,385,385,385,76,25,5,6,7,39,37,74,385,385,385,385,385,385,385,385,385,385,77,78,56,55,57,39,8,385,385,
385,385,11,15,6,16,37,79,80,385,385,385,385,385,385,385,385,385,385,76,15,6,5,16,37,79,80,385,385,385,385,385,385,385,385,385,385,77,81,55,56,73,43,44,385,385,
385,385,19,45,5,7,39,39,82,385,385,385,385,385,385,385,385,385,385,88,89,5,6,7,39,39,82,385,385,385,385,385,385,385,385,385,385,92,93,56,55,57,39,26,385,385,
385,385,29,58,6,16,37,79,80,385,385,385,385,385,385,385,385,385,385,101,15,6,5,16,37,79,80,385,385,385,385,385,385,385,385,385,385,103,81,55,56,73,43,38,385,385,
385,385,2,4,5,7,39,104,105,385,385,385,385,385,385,385,385,385,385,115,89,5,6,7,39,104,105,385,385,385,385,385,385,385,385,385,385,117,93,56,55,57,39,8,385,385,
385,385,11,15,6,16,37,385,385,385,385,391,391,385,385,385,385,385,385,101,15,6,5,16,37,385,385,385,385,390,390,385,385,385,385,385,385,103,81,55,56,73,43,44,385,385,
385,385,19,45,5,7,39,385,385,385,385,127,128,385,385,385,385,385,385,115,89,5,6,7,39,385,385,385,385,127,128,385,385,385,385,385,385,117,93,56,55,57,39,26,385,385,
385,385,29,58,6,35,33,32,33,32,33,136,5,137,33,32,33,32,33,33,34,6,5,35,33,32,33,32,33,136,5,137,33,32,33,138,139,139,140,55,56,73,43,38,385,385,
385,385,2,4,5,5,6,5,6,5,6,5,6,5,6,5,6,5,6,5,6,5,6,5,6,5,6,5,6,5,6,5,6,5,6,5,6,5,6,5,6,141,39,8,385,385,
385,385,11,15,6,6,5,6,5,6,5,6,5,6,5,6,5,6,5,6,5,6,5,6,5,6,5,6,5,6,5,6,5,6,5,6,5,6,5,6,5,16,37,44,385,385,
385,385,19,45,5,5,6,5,6,5,6,5,6,5,6,5,6,5,6,5,6,5,6,5,6,142,143,143,143,143,143,143,143,143,143,144,145,146,147,148,6,7,39,26,385,385,
385,385,29,58,6,59,60,60,61,60,61,60,61,60,61,60,61,60,61,60,68,6,5,59,60,385,385,385,385,385,385,385,385,385,385,385,385,385,385,155,6,16,37,38,385,385,
385,385,2,4,5,7,39,37,74,37,74,37,74,37,74,37,74,37,74,39,25,5,6,7,39,385,385,385,385,385,385,385,385,385,385,385,385,385,385,162,5,7,39,8,385,385,
385,385,11,15,6,16,37,79,80,163,164,165,164,165,164,165,164,166,167,168,15,6,5,16,37,385,385,385,385,385,385,385,385,385,385,385,385,385,385,174,6,16,37,44,385,385,
385,385,19,45,5,7,39,39,82,385,385,385,385,385,385,385,385,385,385,179,89,5,6,7,39,385,385,385,385,385,385,385,385,385,385,385,385,385,385,183,5,7,39,26,385,385,
385,385,186,187,188,189,190,191,192,193,194,193,194,193,195,196,197,198,80,39,15,6,5,16,37,385,385,385,385,385,385,385,385,385,385,385,385,385,385,205,6,16,37,38,385,385,
385,385,208,209,210,211,39,39,212,213,214,213,214,213,215,216,217,218,82,37,89,5,6,7,39,385,385,385,385,385,385,385,385,385,385,385,385,385,385,233,5,7,39,8,385,385,
385,385,236,237,188,238,190,191,239,193,194,193,194,193,195,240,197,198,80,39,15,6,5,16,37,385,385,385,385,385,385,387,387,385,385,385,385,385,385,205,6,16,37,44,385,385,
385,385,253,209,210,211,39,39,212,213,214,213,214,213,215,216,217,218,82,37,89,5,6,7,39,385,385,385,385,385,385,260,261,385,385,385,385,385,385,233,5,7,39,26,385,385,
385,385,266,237,188,267,268,269,268,269,268,269,268,269,33,270,271,272,271,271,273,6,5,35,33,32,33,32,33,32,33,136,5,137,33,32,33,32,33,34,5,16,37,38,385,385,
385,385,208,209,210,210,188,210,188,210,188,210,188,274,6,275,276,277,278,277,278,5,6,5,6,5,6,5,6,56,55,5,6,5,6,5,6,5,6,5,6,7,39,8,385,385,
385,385,236,237,188,188,210,188,210,188,210,188,210,279,5,280,281,282,277,282,277,6,5,6,5,6,5,6,5,55,56,6,5,6,5,6,5,6,5,6,5,16,37,44,385,385,
385,385,253,209,210,210,188,210,188,210,188,210,188,274,6,283,284,277,282,277,282,5,6,5,6,5,6,5,6,56,55,5,6,5,6,5,6,5,6,5,6,7,39,26,385,385,
385,385,266,285,286,286,287,286,287,286,287,286,287,286,68,282,277,282,277,282,277,6,5,6,5,288,289,290,289,290,289,291,292,293,289,290,289,294,5,6,5,16,37,38,385,385,
385,385,208,39,39,190,39,190,39,190,39,190,39,39,25,5,295,5,295,5,295,5,6,5,6,385,385,385,385,385,385,385,385,385,385,385,385,302,6,5,6,7,39,8,385,385,
385,385,304,191,305,306,239,191,305,306,239,191,239,386,386,386,386,386,386,386,386,312,61,60,61,60,61,60,61,60,61,60,61,60,61,60,61,60,61,60,61,313,314,12,385,385,
385,385,316,317,318,319,320,317,318,319,320,39,212,386,386,386,386,386,386,386,386,326,74,37,74,37,74,37,74,37,74,327,328,37,74,37,74,37,74,37,74,39,37,329,385,385,
385,385,266,330,331,332,333,330,331,332,333,191,239,386,386,386,386,386,386,386,386,339,80,340,341,342,341,342,341,342,341,343,344,345,341,342,341,342,346,347,80,198,80,348,385,385,
385,385,385,385,385,385,385,385,385,385,385,39,212,386,386,386,386,386,386,386,386,353,82,354,355,356,355,356,355,356,355,357,358,359,355,356,355,356,360,361,82,39,82,8,385,385,
385,385,385,385,385,385,385,385,385,385,385,191,239,386,386,386,386,386,386,386,386,339,80,198,80,198,80,198,80,198,80,198,80,198,80,198,363,364,80,198,363,364,80,12,385,385,
385,385,385,385,385,385,385,385,385,385,385,39,212,386,386,386,386,386,386,386,386,353,82,39,82,39,82,39,82,39,82,39,82,39,82,367,368,369,370,367,368,369,370,26,385,385,
385,385,385,385,385,385,385,385,385,385,385,385,385,386,386,386,386,386,386,386,386,385,385,385,385,385,385,385,385,385,385,385,385,385,385,376,27,28,29,377,27,28,29,377,385,385,
385,385,385,385,385,385,385,385,385,385,385,385,385,389,389,389,389,389,389,389,389,385,385,385,385,385,385,385,385,385,385,385,385,385,385,385,385,385,385,385,385,385,385,385,385,385,

