1 1 3 3 1 1 3 3 1 1 3 3 1 1 3 3 1 1 3 3 1 1 3 5 5 5 5 3 1 1 3 3 1 1 3 3 1 1 3 3 1 1 3 3 1 1 
1 3 3 3 13 15 3 3 13 15 3 3 13 15 3 3 13 15 3 3 13 15 3 15 5 5 15 3 13 15 3 3 13 15 3 3 13 15 3 3 13 15 3 3 1 3 
1 13 3 1 1 1 33 35 1 1 33 35 1 1 33 35 1 1 33 35 1 1 33 35 5 5 5 35 1 1 33 35 1 1 33 35 1 1 33 35 1 1 33 3 1 13 
1 1 1 31 31 33 33 33 33 33 33 33 33 33 33 33 33 33 33 33 33 33 33 35 5 5 35 33 33 33 33 33 33 33 33 33 33 33 33 33 33 35 35 33 1 1 
1 1 3 5 5 5 5 5 5 5 5 5 5 5 5 5 5 5 5 5 5 5 5 5 5 5 5 5 5 5 5 5 5 5 5 5 5 5 5 5 5 5 31 3 1 1 
1 3 3 15 5 5 5 5 5 5 5 5 5 5 5 5 5 5 5 5 5 5 5 5 5 5 5 5 5 5 5 5 5 5 5 51 51 51 51 51 51 53 53 3 1 3 
1 13 3 55 5 5 5 5 5 3 3 3 3 3 3 3 3 51 3 51 5 5 5 5 5 5 5 3 3 3 3 3 3 3 3 3 3 55 55 55 55 55 31 3 1 13 
1 1 1 53 5 51 51 51 51 1 1 1 1 1 1 1 1 55 1 55 53 5 5 51 51 51 51 1 1 1 1 1 1 1 1 1 1 51 53 55 55 53 53 33 1 1 
1 1 3 5 5 5 31 35 55 55 1 1 1 1 1 1 1 55 1 55 35 5 5 5 31 35 55 55 1 1 1 1 1 1 1 1 1 55 53 55 55 55 31 3 1 1 
1 3 3 15 5 15 35 51 31 55 1 1 1 1 1 1 1 55 1 55 15 5 5 15 35 51 31 55 1 1 1 1 1 1 1 1 1 55 31 55 55 53 53 3 1 3 
1 13 3 55 5 5 31 31 33 1 35 35 35 35 35 35 35 35 35 33 31 5 5 5 31 31 33 1 35 35 35 35 35 35 35 3 1 13 13 55 55 55 31 3 1 13 
1 1 1 53 5 15 35 51 31 1 15 15 15 13 15 15 13 3 1 31 15 5 5 15 35 51 31 1 15 15 15 13 15 15 13 3 1 33 31 55 55 53 53 33 1 1 
1 1 3 5 5 5 31 3 3 1 35 35 33 31 31 31 13 33 1 35 31 5 5 5 31 3 3 1 35 35 33 31 31 31 13 33 1 3 13 55 55 55 31 3 1 1 
1 3 3 15 5 15 35 33 31 1 15 3 3 33 15 15 13 3 1 31 15 5 5 15 35 33 31 1 15 3 3 33 15 15 13 3 1 33 31 55 55 53 53 3 1 3 
1 13 3 55 5 5 31 33 35 1 1 3 3 1 1 1 1 1 135 35 31 5 5 5 31 33 35 1 1 3 3 1 1 1 1 1 1 3 13 55 55 55 31 3 1 13 
1 1 1 53 5 35 33 33 33 33 33 135 5 135 33 33 33 33 33 33 35 5 5 35 33 33 33 33 33 135 5 135 33 33 33 133 131 131 151 55 55 53 53 33 1 1 
1 1 3 5 5 5 5 5 5 5 5 5 5 5 5 5 5 5 5 5 5 5 5 5 5 5 5 5 5 5 5 5 5 5 5 5 5 5 5 5 5 151 31 3 1 1 
1 3 3 15 5 5 5 5 5 5 5 5 5 5 5 5 5 5 5 5 5 5 5 5 5 5 5 5 5 5 5 5 5 5 5 5 5 5 5 5 5 15 35 3 1 3 
1 13 3 55 5 5 5 5 5 5 5 5 5 5 5 5 5 5 5 5 5 5 5 5 5 3 3 3 3 3 3 3 3 3 3 3 3 3 3 13 5 5 31 3 1 13 
1 1 1 53 5 51 51 51 51 51 51 51 51 51 51 51 51 51 51 51 53 5 5 51 51 1 13 13 13 13 13 13 13 13 13 1 13 13 1 155 5 15 35 33 1 1 
1 1 3 5 5 5 31 35 55 35 55 35 55 35 55 35 55 35 55 31 35 5 5 5 31 1 155 155 155 155 155 155 155 155 155 153 151 151 1 3 5 5 31 3 1 1 
1 3 3 15 5 15 35 51 31 3 3 1 3 1 3 1 3 3 3 153 15 5 5 15 35 3 155 155 155 155 155 155 155 155 155 3 3 13 1 15 5 15 35 3 1 3 
1 13 3 55 5 5 31 31 33 15 15 15 15 15 15 15 15 15 13 3 31 5 5 5 31 1 131 131 131 131 131 131 131 131 131 131 131 131 1 3 5 5 31 3 1 13 
135 135 135 135 133 131 31 3 33 33 3 33 3 33 35 35 35 33 31 31 15 5 5 15 35 1 3 3 3 3 13 13 13 13 3 3 3 3 1 15 5 15 35 33 1 1 
15 15 13 3 3 3 31 31 33 13 15 13 15 13 15 15 1 13 33 35 31 5 5 5 31 1 3 3 13 13 15 15 33 1 1 1 331 331 1 333 5 5 31 3 1 1 
335 335 335 335 133 333 31 3 331 33 3 33 3 33 35 351 35 33 31 31 15 5 5 15 35 1 353 353 33 355 33  3  3 351 353 33 355 33 1 15 5 15 35 3 1 3 
351 33 33 3 3 3 31 31 33 13 15 13 15 13 15 15 1 13 33 35 31 5 5 5 31 1 1 1 1 1 1 31 31 1 1 1 1 1 1 333 5 5 31 3 1 13 
1 35 1 335 133 35 33 1 33 1 33 1 33 1 33 1 3 3 3 3 13 5 5 35 33 33 33 33 33 33 33 135 5 135 33 33 33 33 33 35 5 15 35 33 1 1 
15 15 13 3 3 3 133 3 133 3 133 3 133 15 5 15 15 1 13 1 13 5 5 5 5 5 5 5 5 55 55 5 5 5 5 5 5 5 5 5 5 5 31 3 1 1 
335 335 335 335 133 133 3 133 3 133 3 133 3 3 5 3 3 3 1 3 1 5 5 5 5 5 5 5 5 55 55 5 5 5 5 5 5 5 5 5 5 15 35 3 1 3 
351 33 33 3 3 3 133 3 133 3 133 3 133 15 5 1 15 1 3 1 3 5 5 5 5 5 5 5 5 55 55 5 5 5 5 5 5 5 5 5 5 5 31 3 1 13 
1 35 1 15 15 15 1 15 1 15 1 15 1 15 53 3 1 3 1 3 1 5 5 5 5 13 3 3 3 3 3 1 3 13 3 3 3 1 5 5 5 15 35 33 1 1 
15 15 13 31 31 31 31 31 31 31 31 31 31 31 35 5 15 5 15 5 15 5 5 5 5 15 1 13 1 13 1 3 33 33 1 13 1 313 5 5 5 5 31 3 1 1 
335 313 1 3 3 3 331 3 3 3 331 3 331 5 1 5 5 5 5 5 5 33 51 51 51 51 51 51 51 51 51 51 51 51 51 51 51 51 51 51 51 313 315 3 1 3 
351 315 315 3 3 3 3 3 3 3 3 31 33 5 31 333 5 333 5 333 5 33 55 35 55 35 55 35 55 35 55 31 31 35 55 35 55 35 55 35 55 31 35 31 1 13 
1 35 1 1 1 1 1 1 1 1 1 3 331 5 5 1 5 1 5 1 5 331 31 351 351 353 351 353 351 353 351 353 33 355 351 353 351 353 33 33 31 33 31 33 1 1 
15 15 13 351 33 351 33 351 33 351 33 31 33 5 31 333 5 333 5 333 5 33 33 355 355 355 355 355 355 355 355 355 353 351 355 355 355 355 351 351 33 31 33 3 1 1 
335 335 335 31 335 335 335 31 335 335 335 3 331 5 5 1 5 1 5 1 5 331 31 33 31 33 31 33 31 33 31 33 31 33 31 33 31 31 31 33 31 31 31 3 1 3 
351 33 33 355 351 33 31 355 351 33 31 31 33 5 31 333 5 333 5 333 5 33 33 31 33 31 33 31 33 31 33 31 33 31 33 3 3 31 31 3 3 31 31 3 1 13 
1 35 1 351 1 35 1 351 1 35 1 1 1 5 5 1 5 1 5 1 5 353 3 1 3 1 3 1 3 1 3 1 3 355 3 1 1 1 1 1 1 1 1 1 1 1 
15 15 13 353 15 15 13 353 15 15 13 351 331 5 31 333 5 333 5 333 5 331 15 15 15 15 15 15 15 15 15 15 15 333 31 335 1 1 3 3 1 1 3 3 1 1 
